XXXXXXXXXXXXXXXXXXXXX
X     #   #   # # # X
X## # # # # ### # # X
X   #   # #       # X
X## # # # # ##### # X
X   #G# # #     #   X
X## ####### ####### X
X     # #     #     X
X###### # ##### ####X
X   #   # #       # X
X ##### # ### # ### X
X   # #   #   # #   X
X # # # # # ### # ##X
X # #   # #   # #   X
X ### ##### # # # ##X
X # # # #   # #   # X
X## ### ####### ### X
X     # #   #       X
X## ### # # ####### X
X         #      S  X
XXXXXXXXXXXXXXXXXXXXX
